[
  [null, null, 0, 4, 43, 44, 65, 66, 88, null, null, null],
  [null, 2, 1, 3, 42, 45, 64, 89, 86, 87, null, null],
  [6, 5, 11, 7, 47, 67, 68, 85, 93, 90, 94, null],
  [10, 9, 15, 8, 46, 48, 69, 92, 96, 91, 95, 99],
  [14, 13, 19, 12, 20, 49, 70, 71, 100, 97, 98, 103],
  [18, 17, 23, 16, 50, 51, 72, 74, 104, 101, 102, 106],
  [21, 22, 27, 28, 53, 54, 73, 75, 108, 105, 111, 107],
  [25, 26, 31, 32, 56, 52, 76, 77, 112, 109, 118, 110],
  [29, 30, 35, 39, 24, 55, 57, 78, 125, 126, 119, 114],
  [33, 34, 37, 36, 62, 63, 82, 116, 84, 127, 122, 115],
  [null, null, 41, 61, 59, 60, 80, 120, 124, 117, 123, null],
  [null, null, 38, 40, 58, 79, 81, 83, 121, 113, null, null]
]
